49,49,49,49,49,49,49,49,49,49,49,49,49,49,49,49,49,49,49,49,49,49,49,49,49,49,49,49,49,49,49,49,49,49,49,49,49,49,49,49
49,49,49,49,49,49,49,49,49,49,49,49,49,49,49,49,49,49,49,49,49,49,49,49,49,49,49,49,49,49,49,49,49,49,49,49,49,49,49,49
49,49,49,49,49,49,49,49,49,84,70,70,70,86,49,49,49,49,49,49,49,49,49,49,48,48,48,48,48,48,48,48,48,48,48,48,49,49,49,49
49,49,49,49,49,49,49,49,49,66,97,97,97,52,70,70,86,49,49,49,49,49,49,49,48,48,48,48,48,48,48,48,48,48,48,48,48,48,48,48
49,49,49,49,49,49,49,49,49,66,97,97,97,97,97,97,74,49,49,49,49,49,49,49,49,49,48,48,48,48,48,48,48,48,48,48,48,49,48,48
49,49,49,49,49,49,49,49,49,90,58,97,97,97,97,97,74,49,49,49,49,49,49,49,49,49,49,49,49,48,48,48,48,48,48,49,49,49,48,49
49,49,49,49,49,49,49,49,49,49,66,97,97,97,97,54,88,49,49,49,49,49,49,49,49,49,49,49,49,48,48,48,48,48,49,49,49,49,49,49
49,49,49,49,49,49,49,49,49,49,90,78,58,97,97,74,49,49,49,49,49,49,49,49,49,49,49,49,49,49,49,48,48,48,49,49,49,49,49,49
49,49,49,49,49,49,49,49,49,49,49,49,66,97,97,52,86,49,49,49,49,49,49,49,49,49,49,49,49,49,49,49,49,49,49,49,49,49,49,49
49,49,49,49,49,49,49,49,49,49,49,49,66,97,97,97,52,86,49,49,49,49,49,49,49,49,49,49,48,48,49,49,48,49,49,49,49,49,49,49
49,49,49,49,49,49,49,49,49,49,49,49,66,97,97,97,97,52,70,86,49,49,49,49,49,49,49,48,48,48,49,48,48,49,49,49,49,49,49,49
49,49,49,49,49,49,49,49,49,49,49,49,66,97,97,97,97,97,97,52,86,49,49,49,48,48,48,48,48,48,49,48,48,49,49,49,49,49,49,49
49,49,49,49,49,49,49,49,49,49,49,49,90,58,97,97,97,97,97,97,74,49,49,48,48,48,48,48,48,48,49,49,49,48,49,49,49,49,49,49
49,49,49,49,49,49,49,49,49,49,49,49,49,90,78,78,78,78,78,78,88,49,49,48,48,48,48,48,48,48,49,49,48,48,49,49,49,49,49,49
49,49,49,49,49,49,49,49,49,49,49,49,49,49,49,49,49,49,49,49,49,49,49,49,48,48,48,49,49,49,49,48,48,48,48,49,49,49,48,49
49,49,49,49,49,49,49,49,49,49,49,49,49,49,49,49,49,49,49,49,49,49,49,49,48,48,48,49,49,49,49,49,48,48,48,48,49,49,49,49
49,49,49,49,49,49,49,49,49,49,49,49,49,49,49,49,49,49,49,49,49,49,49,49,49,48,48,48,49,49,49,48,48,48,49,49,49,49,49,49
49,49,49,49,49,49,49,49,49,49,49,49,49,49,49,49,49,49,49,49,49,49,49,49,49,48,49,48,49,49,49,49,48,49,49,49,49,49,49,49
49,49,49,49,49,49,49,49,49,49,49,49,49,49,49,49,49,49,49,49,49,49,49,49,49,49,48,48,49,49,48,48,48,49,49,49,49,49,49,49
49,49,49,49,49,49,49,49,49,49,49,49,49,49,49,49,49,49,49,49,49,49,49,49,49,49,48,48,48,49,48,48,49,49,49,49,49,49,49,49
49,49,49,49,49,49,49,49,49,49,49,49,49,49,49,49,49,49,49,49,49,49,49,49,49,49,49,48,48,49,49,49,49,49,49,49,49,49,49,49
49,49,49,49,49,49,49,49,49,49,49,49,49,49,49,49,49,49,49,49,49,49,49,49,49,49,49,49,49,49,49,49,49,49,49,49,49,49,49,49
49,49,49,49,49,49,49,49,49,49,49,49,49,49,49,49,49,49,49,49,49,49,49,49,49,49,49,49,49,49,49,49,49,49,49,49,49,49,49,49