049,049,049,049,049,049,049,049,049,049,049,049,049,049,049,049,049,049,049,049,049,049,049,049,049,049,049,049,049,049,049,049,049,049,049,049,049,049,049,049
049,049,049,049,049,049,049,049,049,049,049,049,049,049,049,049,049,049,049,049,049,049,049,049,049,049,049,049,049,049,049,049,049,049,049,049,049,049,049,049
049,049,049,049,049,049,049,049,049,048,048,048,048,048,048,048,048,048,049,049,049,049,049,049,048,048,048,048,048,048,048,048,048,048,048,048,049,049,049,049
049,049,049,049,049,049,049,048,048,048,048,048,048,048,048,048,048,048,049,049,049,049,049,049,048,048,048,048,048,048,048,048,048,048,048,048,048,048,048,048
049,049,049,049,049,049,049,048,048,048,048,048,048,048,048,048,048,048,048,049,049,049,049,049,049,049,048,048,048,048,048,048,048,048,048,048,048,049,048,048
049,049,049,049,049,049,049,048,048,048,048,048,048,048,048,048,048,048,048,048,049,049,049,049,049,049,049,049,049,048,048,048,048,048,048,049,049,049,048,049
049,049,049,049,049,049,049,049,049,048,048,048,048,048,048,048,048,048,048,048,049,049,049,049,049,049,049,049,049,048,048,048,048,048,049,049,049,049,049,049
049,049,049,049,049,049,049,049,049,049,048,048,048,048,048,048,048,048,048,048,048,049,049,049,049,049,049,049,049,049,049,048,048,048,049,049,049,049,049,049
049,049,049,049,049,049,049,049,049,049,048,048,048,048,048,048,048,048,048,048,048,048,049,049,049,049,049,049,049,049,049,049,049,049,049,049,049,049,049,049
049,049,049,049,049,049,049,049,049,049,048,048,048,048,048,048,048,048,048,048,048,048,048,049,049,049,049,049,048,048,049,049,048,049,049,049,049,049,049,049
049,049,049,049,049,049,049,049,049,049,048,048,048,048,048,048,048,048,048,048,048,048,048,048,048,049,049,048,048,048,049,048,048,049,049,049,049,049,049,049
049,049,049,049,049,049,112,112,049,049,048,048,048,048,048,048,048,112,112,112,112,112,048,048,048,048,048,048,112,112,112,112,112,049,049,049,049,049,049,049
049,049,049,049,049,112,119,119,112,048,048,048,048,048,048,048,048,119,119,119,119,119,048,048,048,048,048,048,119,119,119,119,119,048,049,049,049,049,049,049
121,112,112,112,112,119,119,119,119,112,112,112,112,112,112,112,112,119,119,119,119,119,112,112,112,112,112,112,119,119,119,119,119,112,112,112,112,112,112,113
118,119,119,119,119,119,119,119,119,119,119,119,119,119,119,119,119,119,119,119,119,119,119,119,119,119,119,119,119,119,119,119,119,119,119,119,119,119,119,120
118,119,119,119,119,119,119,119,119,119,119,119,119,119,119,119,119,119,119,119,119,119,119,119,119,119,119,119,119,119,119,119,119,119,119,119,119,119,119,120
118,119,119,119,119,119,119,119,119,119,119,119,119,119,119,119,119,119,119,119,119,119,119,119,119,119,119,119,119,119,119,119,119,119,119,119,119,119,119,120
118,119,119,119,119,119,119,119,119,119,119,119,119,119,119,119,119,119,119,119,119,119,119,119,119,119,119,119,119,119,119,119,119,119,119,119,119,119,119,120
118,119,119,119,119,119,119,119,119,119,119,119,119,119,119,119,119,119,119,119,119,119,119,119,119,119,119,119,119,119,119,119,119,119,119,119,119,119,119,120
118,119,119,119,119,119,119,119,119,119,119,119,119,119,119,119,119,119,119,119,119,119,119,119,119,119,119,119,119,119,119,119,119,119,119,119,119,119,119,120
118,119,119,119,119,119,119,119,119,119,119,119,119,119,119,119,119,119,119,119,119,119,119,119,119,119,119,119,119,119,119,119,119,119,119,119,119,119,119,120
118,119,119,119,119,119,119,119,119,119,119,119,119,119,119,119,119,119,119,119,119,119,119,119,119,119,119,119,119,119,119,119,119,119,119,119,119,119,119,120
125,126,126,126,126,126,126,126,126,126,126,126,126,126,126,126,126,126,126,126,126,126,126,126,126,126,126,126,126,126,126,126,126,126,126,126,126,126,126,127

0,0,0,0,0,0,0,0,0,0,0,0,0,0,0,0,0,0,0,0,0,0,0,0,0,0,0,0,0,0,0,0,0,0,0,0,0,0,0,0
0,0,0,0,0,0,0,0,0,0,0,0,0,0,0,0,0,0,0,0,0,0,0,0,0,0,0,0,0,0,0,0,0,0,0,0,0,0,0,0
0,0,0,0,0,0,0,0,0,0,0,0,0,0,0,0,0,0,0,0,0,0,0,0,0,0,0,0,0,0,0,0,0,0,0,0,0,0,0,0
0,0,0,0,0,0,0,0,0,0,0,0,0,0,0,0,0,0,0,0,0,0,0,0,0,0,0,0,0,0,0,0,0,0,0,0,0,0,0,0
0,0,0,0,0,0,0,0,0,0,0,0,0,0,0,0,0,0,0,0,0,0,0,0,0,0,0,0,0,0,0,0,0,0,0,0,0,0,0,0
0,0,0,0,0,0,0,0,0,0,0,0,0,0,0,0,0,0,0,0,0,0,0,0,0,0,0,0,0,0,0,0,0,0,0,0,0,0,0,0
0,0,0,0,0,0,0,0,0,0,0,0,0,0,0,0,0,0,0,0,0,0,0,0,0,0,0,0,0,0,0,0,0,0,0,0,0,0,0,0
0,0,0,0,0,0,0,0,0,0,0,0,0,0,0,0,0,0,0,0,0,0,0,0,0,0,0,0,0,0,0,0,0,0,0,0,0,0,0,0
0,0,0,0,0,0,0,0,0,0,0,0,0,0,0,0,0,0,0,0,0,0,0,0,0,0,0,0,0,0,0,0,0,0,0,0,0,0,0,0
0,0,0,0,0,0,0,0,0,0,0,0,0,0,0,0,0,0,0,0,0,0,0,0,0,0,0,0,0,0,0,0,0,0,0,0,0,0,0,0
0,0,0,0,0,0,0,0,0,0,0,0,0,0,0,0,0,0,0,0,0,0,0,0,0,0,0,0,0,0,0,0,0,0,0,0,0,0,0,0
0,0,0,0,0,0,0,0,0,0,0,0,0,0,0,0,0,0,0,0,0,0,0,0,0,0,0,0,0,0,0,0,0,0,0,0,0,0,0,0
0,0,0,0,0,0,1,1,0,0,0,0,0,0,0,0,0,1,1,1,1,1,0,0,0,0,0,0,1,1,1,1,1,0,0,0,0,0,0,0
0,0,0,0,0,1,1,1,1,0,0,0,0,0,0,0,0,1,0,0,0,1,0,0,0,0,0,0,1,0,0,0,1,0,0,0,0,0,0,0
1,1,1,1,1,1,0,0,1,1,1,1,1,1,1,1,1,1,0,0,0,1,1,1,1,1,1,1,1,0,0,0,1,1,1,1,1,1,1,1
0,0,0,0,0,0,0,0,0,0,0,0,0,0,0,0,0,0,0,0,0,0,0,0,0,0,0,0,0,0,0,0,0,0,0,0,0,0,0,0
0,0,0,0,0,0,0,0,0,0,0,0,0,0,0,0,0,0,0,0,0,0,0,0,0,0,0,0,0,0,0,0,0,0,0,0,0,0,0,0
0,0,0,0,0,0,0,0,0,0,0,0,0,0,0,0,0,0,0,0,0,0,0,0,0,0,0,0,0,0,0,0,0,0,0,0,0,0,0,0
0,0,0,0,0,0,0,0,0,0,0,0,0,0,0,0,0,0,0,0,0,0,0,0,0,0,0,0,0,0,0,0,0,0,0,0,0,0,0,0
0,0,0,0,0,0,0,0,0,0,0,0,0,0,0,0,0,0,0,0,0,0,0,0,0,0,0,0,0,0,0,0,0,0,0,0,0,0,0,0
0,0,0,0,0,0,0,0,0,0,0,0,0,0,0,0,0,0,0,0,0,0,0,0,0,0,0,0,0,0,0,0,0,0,0,0,0,0,0,0
0,0,0,0,0,0,0,0,0,0,0,0,0,0,0,0,0,0,0,0,0,0,0,0,0,0,0,0,0,0,0,0,0,0,0,0,0,0,0,0
0,0,0,0,0,0,0,0,0,0,0,0,0,0,0,0,0,0,0,0,0,0,0,0,0,0,0,0,0,0,0,0,0,0,0,0,0,0,0,0