2
001,001,001,001,001,001,001,001,001,001,001,001,001,001,001,001,001,001,001,001,001,001,001,001,001,014,014,001,001,001,001,001,001,001,001,001,001,001,001,001,
001,001,001,001,001,001,001,001,001,001,001,001,001,001,001,001,001,001,001,001,001,001,001,001,001,001,014,001,001,001,001,001,001,001,001,001,001,001,001,001,
001,001,001,001,001,001,001,001,001,001,001,001,001,001,001,001,001,001,001,001,001,001,001,001,001,001,014,001,001,001,001,001,001,001,001,001,001,001,001,001,
001,001,001,001,001,001,001,001,001,001,001,001,001,001,001,001,001,001,001,001,001,001,001,001,001,001,014,014,001,001,001,001,001,001,001,001,001,001,001,001,
001,001,001,001,001,001,001,001,001,001,001,001,001,001,001,001,001,001,001,001,001,001,001,001,001,001,001,014,001,001,001,001,001,001,001,001,001,001,001,001,
001,001,001,001,001,001,001,001,001,001,001,001,001,001,001,001,001,001,001,001,001,001,001,001,001,001,001,014,014,001,001,001,001,001,001,001,001,001,001,001,
001,001,001,001,001,001,001,001,001,001,001,001,001,001,001,001,001,001,001,001,001,001,001,001,001,001,001,001,026,001,001,001,001,001,001,001,001,001,001,001,
001,001,001,001,001,001,001,001,001,001,001,001,001,001,001,001,001,001,001,001,001,001,001,001,001,001,001,001,001,001,001,001,014,001,001,001,001,001,001,001,
001,001,001,001,001,001,001,001,001,001,018,018,018,018,001,001,001,001,001,001,001,001,001,001,001,001,001,001,001,026,001,001,001,001,001,001,001,001,001,001,
001,001,001,001,001,001,001,001,001,001,018,001,001,018,001,001,001,001,001,001,001,001,001,001,001,001,001,001,001,001,001,001,001,001,001,001,001,001,001,001,
001,001,001,001,001,001,001,001,001,001,018,001,001,018,001,001,001,001,001,001,001,001,001,001,001,001,001,001,001,001,001,001,001,001,001,001,001,001,001,001,
001,001,001,001,001,001,001,001,001,001,001,028,028,001,001,001,001,001,001,001,001,001,001,001,001,001,001,001,001,001,001,001,001,001,001,001,001,001,001,001,
001,001,001,001,001,001,001,001,001,001,001,028,028,001,001,001,001,001,001,001,001,001,001,001,001,001,001,001,001,001,001,001,001,001,001,001,001,001,001,001,
001,001,001,001,001,001,001,001,001,001,001,028,028,001,001,001,001,001,001,001,001,001,001,001,001,001,001,001,001,001,001,001,001,001,001,001,001,001,001,001,
001,001,001,001,001,001,001,001,001,001,001,028,028,001,001,001,001,001,001,001,001,001,001,001,028,028,001,001,001,001,001,001,001,001,001,001,001,001,001,001,
001,001,001,001,001,001,001,001,001,001,001,028,028,001,001,001,001,001,001,001,001,001,001,001,028,028,001,001,001,001,001,001,001,001,001,001,001,001,001,001,
001,001,001,001,001,001,001,001,001,001,001,028,028,001,001,001,001,001,001,001,001,001,001,001,028,028,001,001,001,001,001,001,001,001,001,001,001,001,001,001,
001,001,001,001,001,001,001,001,001,001,001,028,028,028,028,028,028,028,028,028,028,028,028,028,028,028,001,001,001,001,001,001,001,001,001,001,001,001,001,001,
001,001,001,001,001,001,001,001,001,001,001,028,028,028,028,028,028,028,028,028,028,028,028,028,028,028,001,001,001,001,001,001,001,001,001,001,001,001,001,001,
001,001,001,001,001,001,001,001,001,001,001,001,001,001,001,001,001,001,001,001,001,001,001,001,001,001,001,001,001,001,001,001,001,001,001,001,001,001,001,001,
001,001,001,001,001,001,001,001,001,001,001,001,001,001,001,001,001,001,001,001,001,001,001,001,001,001,001,001,001,001,001,001,001,001,001,001,001,001,001,001,
001,001,001,001,001,001,001,001,001,001,001,001,001,001,001,001,001,001,001,001,001,001,001,001,001,001,001,001,001,001,001,001,001,001,001,001,001,001,001,001,
001,001,001,001,001,001,001,001,001,001,001,001,001,001,001,001,001,001,001,001,001,001,001,001,001,001,001,001,001,001,001,001,001,001,001,001,001,001,001,001,

179,179,179,179,179,179,179,179,179,179,179,179,179,179,179,179,179,179,179,179,179,179,179,179,179,179,179,179,179,179,179,179,179,179,179,179,179,179,179,179,
179,179,179,179,179,179,179,179,179,179,179,179,179,179,179,179,179,179,179,179,179,179,179,179,179,179,179,179,179,179,179,179,179,179,179,179,179,179,179,179,
179,179,179,179,179,179,179,179,179,179,179,179,179,179,179,179,179,179,179,179,179,179,179,179,179,179,179,179,179,179,179,179,179,179,179,179,179,179,179,179,
179,179,179,179,179,179,179,179,179,179,179,179,179,179,179,179,179,179,179,179,179,179,179,179,179,179,179,179,179,179,179,179,179,179,179,179,179,179,179,179,
179,179,179,179,179,179,179,179,179,179,179,179,179,179,179,179,179,179,179,179,179,179,179,179,179,179,179,179,179,179,179,179,179,179,179,179,179,179,179,179,
179,179,179,179,179,179,179,179,179,179,179,179,179,179,179,179,179,179,179,179,179,178,110,111,111,111,111,112,178,179,179,179,179,179,179,179,179,179,179,179,
179,179,179,179,179,179,179,179,179,179,179,179,179,179,179,179,179,179,179,179,179,178,120,034,034,034,178,122,178,179,179,179,179,179,179,179,179,179,179,179,
179,179,179,179,179,179,179,179,179,179,179,179,179,179,179,179,179,179,179,179,179,178,120,015,018,024,026,122,178,179,179,179,179,179,179,179,179,179,179,179,
179,179,179,179,179,179,179,179,179,179,110,111,111,112,179,179,179,179,179,179,179,178,120,015,015,026,026,122,178,179,179,179,179,179,179,179,179,179,179,179,
179,179,179,179,179,179,179,179,179,179,120,018,018,122,179,179,179,179,179,179,179,178,120,018,018,018,018,122,178,179,179,179,179,179,179,179,179,179,179,179,
179,179,179,179,179,179,179,179,179,179,120,018,018,122,179,179,179,179,179,179,179,178,130,131,072,081,131,132,178,179,179,179,179,179,179,179,179,179,179,179,
179,179,179,179,179,179,179,179,179,179,130,072,081,132,179,179,179,179,179,179,179,179,140,141,082,083,141,142,179,179,179,179,179,179,179,179,179,179,179,179,
179,179,179,179,179,179,179,179,179,179,140,082,083,142,179,179,179,179,179,179,179,179,177,177,082,083,177,177,179,179,179,179,179,179,179,179,179,179,179,179,
179,179,179,179,179,179,179,179,179,179,179,092,093,179,179,179,179,179,179,179,179,179,179,179,092,093,179,179,179,179,179,179,179,179,179,179,179,179,179,179,
179,179,179,179,179,179,179,179,179,179,179,179,179,179,179,179,179,179,179,179,179,179,179,179,179,179,179,179,179,179,179,179,179,179,179,179,179,179,179,179,
179,179,179,179,179,179,179,179,179,179,179,179,179,179,179,179,179,179,179,179,179,179,179,179,179,179,179,179,179,179,179,179,179,179,179,179,179,179,179,179,
179,179,179,179,179,179,179,179,179,179,179,179,179,179,179,179,179,179,179,179,179,179,179,179,179,179,179,179,179,179,179,179,179,179,179,179,179,179,179,179,
179,179,179,179,179,179,179,179,179,179,179,179,179,179,179,179,179,179,179,179,179,179,179,179,179,179,179,179,179,179,179,179,179,179,179,179,179,179,179,179,
179,179,179,179,179,179,179,179,179,179,179,179,179,179,179,179,179,179,179,179,179,179,179,179,179,179,179,179,179,179,179,179,179,179,179,179,179,179,179,179,
179,179,179,179,179,179,179,179,179,179,179,179,179,179,179,179,179,179,179,179,179,179,179,179,179,179,179,179,179,179,179,179,179,179,179,179,179,179,179,179,
179,179,179,179,179,179,179,179,179,179,179,179,179,179,179,179,179,179,179,179,179,179,179,179,179,179,179,179,179,179,179,179,179,179,179,179,179,179,179,179,
179,179,179,179,179,179,179,179,179,179,179,179,179,179,179,179,179,179,179,179,179,179,179,179,179,179,179,179,179,179,179,179,179,179,179,179,179,179,179,179,
179,179,179,179,179,179,179,179,179,179,179,179,179,179,179,179,179,179,179,179,179,179,179,179,179,179,179,179,179,179,179,179,179,179,179,179,179,179,179,179,
